00000000000
00000000000
00000000000
00000000000
00000000000
00000000000
000000BBB00
0BB00000000
00000000000
###########