000000000000000000000000000000000000000000000000000000000000000000
000000000000000000000000000000000000000000000000000000000000000000
000000000000000000000000000000000000000000000000000000000000000000
000000000000000000000000000000000000000000000000000000000000000000
000000000000000000000000000000000000000000000000000000000000000000
000000000000000000000000000000000000000000000000000000000000000000
0000Q0000000000000000000000000000000000000000000000000000000000000
000000000000000000000000000000000000000000000000000000000000000000
00000BB00000000000000000000000000000000000000000000000000000000000
000000000000000000000000000000000000000000000000000000000000000000
000000000000000000000000000000000000000000000000000000000000000000
00000000000BB00000000000000000000000000000000000000000000000000000
00000000000000000000000000000BB00000000000000000000000000000000000
##################################################################