00000000000
00000000000
00000000000
00000000000
00000000000
0000BB0000
000000BBB00
00000000000
00000000000
###########